data,stato,codice_regione,denominazione_regione,lat,long,ricoverati_con_sintomi,terapia_intensiva,totale_ospedalizzati,isolamento_domiciliare,totale_positivi,variazione_totale_positivi,nuovi_positivi,dimessi_guariti,deceduti,casi_da_sospetto_diagnostico,casi_da_screening,totale_casi,tamponi,casi_testati,note,ingressi_terapia_intensiva,note_test,note_casi,totale_positivi_test_molecolare,totale_positivi_test_antigenico_rapido,tamponi_test_molecolare,tamponi_test_antigenico_rapido,codice_nuts_1,codice_nuts_2
2021-02-06T17:00:00,ITA,13,Abruzzo,42.35122196,13.39843823,461,49,510,10042,10552,326,509,32918,1502,,,44972,736955,379823,Dal totale dei positivi è stato corretto un caso in quanto errato positivo,4,,,44972,0,645388,91567,ITF,ITF1
2021-02-06T17:00:00,ITA,17,Basilicata,40.63947052,15.80514834,84,1,85,3192,3277,-64,85,9995,337,,,13609,220528,132669,"IN CORSO VERIFICA E VALIDAZIONE  DEL NUMERO TOTALE DEI GUARITI DELLA REGIONE BASILICATA DA PIATTAFORMA REGIONALE Covid-19. IL NUMERO TOTALE DEI DECESSI COMPRENDE 11 SOGGETTI NON RESIDENTI, DECEDUTI  IN STRUTTURE OSPEDALIERE DELLA REGIONE BASILICATA. ",0,,,13609,0,215657,4871,ITF,ITF5
2021-02-06T17:00:00,ITA,18,Calabria,38.90597598,16.59440194,249,27,276,7866,8142,-205,197,25305,617,,,34064,534256,504906,,1,,,34058,6,529061,5195,ITF,ITF6
2021-02-06T17:00:00,ITA,15,Campania,40.83956555,14.25084984,1499,108,1607,62633,64240,921,1546,162264,3888,,,230392,2525894,1788715,,12,,,228412,1980,2486116,39778,ITF,ITF3
2021-02-06T17:00:00,ITA,08,Emilia-Romagna,44.49436681,11.341720800000001,1956,183,2139,40509,42648,-488,1383,173085,9812,,,225545,3247836,1385467,"Sono stati eliminati 2 casi, in quanto giudicati non casi COVID-19",17,,,225479,66,3070594,177242,ITH,ITH5
2021-02-06T17:00:00,ITA,06,Friuli Venezia Giulia,45.6494354,13.76813649,533,63,596,10276,10872,-183,413,56408,2547,,,69827,1191476,432116,,4,,,66691,3136,1141573,49903,ITH,ITH4
2021-02-06T17:00:00,ITA,12,Lazio,41.89277044,12.48366722,2273,270,2543,53900,56443,-378,1014,149818,5239,,,211500,3498179,2485629,,16,,,210137,1363,3146270,351909,ITI,ITI4
2021-02-06T17:00:00,ITA,07,Liguria,44.41149315,8.9326992,609,61,670,3924,4594,107,276,63346,3445,,,71385,898257,388159,,3,,in Regione Liguria la positività al test antigenico rapido è seguita da conferma con test molecolare.,71385,0,843214,55043,ITC,ITC3
2021-02-06T17:00:00,ITA,03,Lombardia,45.46679409,9.190347404,3540,354,3894,44415,48309,107,1923,472266,27395,,,547970,5852056,2885842,,22,,,545694,2276,5665314,186742,ITC,ITC4
2021-02-06T17:00:00,ITA,11,Marche,43.61675973,13.5188753,531,75,606,7019,7625,-302,436,48089,2033,,,57747,718208,433086,,4,,,57747,0,684797,33411,ITI,ITI3
2021-02-06T17:00:00,ITA,14,Molise,41.55774754,14.65916051,66,12,78,1235,1313,20,78,7178,285,,,8776,142685,129134,,3,,,8776,0,142413,272,ITF,ITF2
2021-02-06T17:00:00,ITA,21,P.A. Bolzano,46.49933453,11.35662422,242,34,276,4716,4992,-1381,802,38122,897,,,44011,543822,185338,,0,,,37780,6231,441234,102588,ITH,ITH1
2021-02-06T17:00:00,ITA,22,P.A. Trento,46.06893511,11.12123097,131,28,159,2465,2624,109,278,24949,1160,,,28733,546110,163333,,1,,,25746,2987,521072,25038,ITH,ITH2
2021-02-06T17:00:00,ITA,01,Piemonte,45.0732745,7.680687483,2007,140,2147,10035,12182,-13,717,206479,8994,,,227655,2178038,1128845,,8,,,225079,2576,1920280,257758,ITC,ITC1
2021-02-06T17:00:00,ITA,16,Puglia,41.12559576,16.86736689,1427,157,1584,49491,51075,49,926,73859,3391,,,128325,1366157,783795,,9,,,127912,413,1338188,27969,ITF,ITF4
2021-02-06T17:00:00,ITA,20,Sardegna,39.21531192,9.110616306,394,31,425,14223,14648,-58,125,23709,1016,,,39373,599083,491094,,5,,Si segnala il decesso dei paz.:  - 1 uomo 60 aa Residente nella Città Metropolitana di Cagliari  - 1 donna 87 aa Residente nella Città Metropolitana di Cagliari  - 1 uomo 66 aa Residente nella Provincia di Sassari  - 1 uomo 90 aa Residente nella Provincia di Sassari  - 1 uomo 87 aa Residente nella Provincia di Sassari  - 1 uomo 98 aa Residente nella Provincia di Sassari ,39370,3,586138,12945,ITG,ITG2
2021-02-06T17:00:00,ITA,19,Sicilia,38.11569725,13.362356699999998,1228,177,1405,37861,39266,-288,836,98057,3657,,,140980,1936886,1019978,,10,,,140980,0,1563868,373018,ITG,ITG1
2021-02-06T17:00:00,ITA,09,Toscana,43.76923077,11.25588885,643,109,752,9513,10265,173,708,123389,4296,,,137950,2327331,1237112,,10,,,137785,165,2206468,120863,ITI,ITI1
2021-02-06T17:00:00,ITA,10,Umbria,43.10675841,12.38824698,388,70,458,6124,6582,184,351,30689,831,,,38102,671839,291099,"Si fa presente che 38 dei ricoveri NON UTI, sono post-acuti COD. n.56 e COD n.60 (quindi reparti riabilitativi e lungo-degenza). ",6,,,38102,0,616821,55018,ITI,ITI2
2021-02-06T17:00:00,ITA,02,Valle d'Aosta,45.73750286,7.320149366,24,3,27,141,168,-11,8,7266,408,,,7842,71659,41965,,0,,,7842,0,70246,1413,ITC,ITC2
2021-02-06T17:00:00,ITA,05,Veneto,45.43490485,12.33845213,1123,158,1281,25936,27217,-709,831,279870,9253,,,316340,4348682,1338389,Nei valori riportati per le terapie intensive si è verificato un disallineamento temporale del flusso informativo pertanto per convenzione è stato riportato n.  16 dimissioni da TI invece delle  18 effettive che includono anche i negativizzati.,9,,,314492,1848,3813994,534688,ITH,ITH3
